1,1,1,1,1,1,1,1,1,1,1,1,1,1,1,1,1,1,1,1 
1,0,0,0,0,7,0,7,0,0,0,7,0,0,0,0,0,0,0,1 
1,0,0,0,0,0,0,0,0,0,0,0,0,0,0,0,0,0,0,1 
1,0,0,0,0,0,0,0,0,0,0,0,0,0,0,0,0,0,0,1 
1,0,0,3,0,0,0,0,0,0,0,0,0,7,4,5,0,0,0,1 
1,0,0,0,0,0,0,0,0,0,0,0,0,0,0,0,0,0,0,1
1,0,0,0,0,0,0,0,0,0,0,0,0,0,0,0,0,0,0,1
1,0,0,0,0,0,0,0,0,0,0,0,0,0,0,0,0,0,0,1
1,0,0,0,0,0,0,0,0,0,0,0,0,0,0,0,0,0,0,1
1,0,0,0,0,7,0,7,0,0,0,7,0,0,7,0,0,0,0,1
1,0,0,0,0,0,0,0,0,0,0,0,0,0,0,0,0,0,0,1
1,0,0,0,0,0,0,0,0,0,8,0,0,0,0,0,0,0,0,1
1,0,0,0,0,0,0,0,0,0,0,0,0,0,0,0,0,2,0,1
1,0,0,0,0,0,0,0,0,0,7,0,7,0,0,0,0,2,0,1
1,0,0,0,0,0,0,0,0,0,0,0,0,0,0,0,0,2,0,1
1,0,0,0,0,0,0,0,0,0,2,0,2,0,2,2,2,2,0,1
1,0,0,0,0,0,0,1,1,6,6,6,6,6,1,1,1,1,1,1
1,0,0,0,0,0,0,2,1,1,1,1,1,1,1,1,1,1,1,1
1,2,2,2,2,2,1,2,1,1,1,1,1,1,1,1,1,1,1,1
1,1,1,1,1,1,1,1,1,1,1,1,1,1,1,1,1,1,1,1
