1,1,1,1,1,1,1,1,1,1,1,1,1,1,1,1,1,1,1,1
1,0,0,0,0,0,0,0,0,0,0,0,0,0,0,0,0,0,0,1 
1,0,0,0,0,0,0,0,0,0,0,0,0,0,0,0,0,0,0,1 
1,0,0,0,0,0,0,0,0,0,0,0,0,0,0,0,0,0,0,1
1,0,0,0,0,0,0,0,0,0,0,0,0,0,0,0,0,0,0,1 
1,0,0,0,0,0,0,0,0,0,0,0,0,0,0,0,0,0,0,1 
1,0,0,0,0,0,0,0,0,0,0,8,0,0,0,0,0,0,0,1 
1,0,0,0,0,0,0,0,0,0,0,0,0,0,0,0,0,0,0,1 
1,0,0,0,0,0,0,0,0,7,0,2,0,0,0,0,0,0,0,1 
1,0,0,0,0,0,0,0,0,0,0,0,0,0,0,0,0,0,0,1 
1,0,0,0,0,0,0,0,0,3,0,0,0,3,0,0,0,0,0,1 
1,0,0,0,0,0,0,0,4,5,0,0,4,5,0,0,0,0,0,1 
1,0,0,0,0,0,0,0,0,0,0,0,0,0,0,0,0,0,0,1 
1,0,0,0,7,0,0,0,0,0,0,0,0,0,0,0,0,0,0,1 
1,0,0,0,1,0,0,1,0,0,1,0,0,1,0,0,1,0,0,1 
1,0,0,0,7,0,0,0,0,0,0,0,0,0,0,0,0,0,0,1 
1,0,0,0,0,0,0,0,0,0,0,0,0,0,0,0,0,0,0,1 
1,0,0,1,6,6,6,6,6,6,6,6,6,6,6,6,6,6,1,1 
1,0,0,1,0,0,0,0,0,0,0,0,0,0,0,0,0,0,0,1 
1,1,1,1,1,1,1,1,1,1,1,1,1,1,1,1,1,1,1,1 
